
  Greets.
  +-----+

  lev           - you did a good job with boza ;P
  lapse         - step to this, i dare ya.
  black avenger - less vodka and more coding ;)
  fury          - the heartless hall monitor
  halflife      - thanks for the accounts.  i love ya.
  nimrood       - epyx fast loader owns me, 1000 thanks.
  mujahadin     - it's jihad time.  keep rockin'
  digital       - phear macarena.
  lookout man   - hehe
  kdkd          - hardware envy ;)
  sepultura     - you can't, you won't and it don't stop.
  stormbringer  - gimme the vlad homepage back !@$#
  rebyc         - time to settle down :|
  thefloyd      - when polyester isn't enough..
  retch         - buy a soundcard.
  tu            - thanks for the emails, i'll get to 'em
  rilo          - ik zal godverdomme een kwak langs
                  je huig laten gieren !@$#
  tyzm          - teach me more dutch :P
  h8            - still waiting.
  omega         - i'll make sure i give you my sources ;)
  rhince        - keep in touch.
  antigen       - got some poetry to show you.
  ao            - since 1994 ?
  slash         - good luck with the macro format
  galar         - norway in the house
  b0z0          - free padania
  dark angel    - see you at lawn bowls on saturday
  automag       - hope things are going ok for ya.
  xenophon      - i'll add you to the page one day..
  ncl           - where's metabolis.com ??

  Not in the list ?
  Feeling left out ?
  Be content that we forget ourselves occasionally.

